1111111111111111111111111
1000000000000000000000001
1111101111110111111011111
100000000C00000E00000P001
1111111111111111111111111