1111111111111111111111111111111111111
1P00000000C000000CCC0000000000E000001
1111111111111111111111111111111111111