1111111111111111
110000E000000011
1111011101110011
111100P0C1111111
1111111111111111