1111111111111111111
1P00010C01E000001C1
10000101010000C0001
10C0010101111111001
10000C0100C00000011
1111111111111111111